111111111
10010C001
100P00011
10100E001
1C1000001
100C00001
111111111