1111111111111
1001C00000001
111100000P111
1C001100000C1
11C00000E0001
100000CC00001
1111111111111