11111111111111111111111111111
10000000000100C00000C00000111
100O000C000000000000011100001
1C000000P100000001000000COO01
1111O011000000000E000000000C1
1000010000O1000OCO00000111101
10000000OC00000C00000CO000001
11111111111111111111111111111
