111111
10C0C1
1E0001
1C0101
111111