111111
1PE001
110C01
1C0001
111111