1111111
1C01C01
1111P01
1000C01
1EC00C1
1111111